Battlefield
2
50 50
PPPPPPPPPPPPPPPPPPPPPPPPPWWWPPPPPPPPPPPPPPPPPPPPPP
PPPPPPPPPPPPPPPPPPPPPGPPPWWWPPPGPPPPPPPPPPPPPPPPPP
PPPPPPPPPPPPPPPPPPPPPPPPPWWWPPPPPPPPPPPPPPPPPPPPPP
PPPPPPPPPPPPPPPPPPPPPPPPPPPPPPPPPPPPPPPPPPPPPPPPPP
PPPPPPPPPPPPPPPPPPPPPPPPPPPPPPPPPPPPPPPPPPPPPPPPPP
PPPPPPPPPPPPPPPPPPPPPPPPPWWWPPPPPPPPPPPPPPPPPPPPPP
PPPPPPPMMPPPPPPPMMPPPPPPPWWWPPPPPPPPMPPPPPPPPMPPPP
PPPPPPPMMPPPGPPPPMMPPFPPPWWWPPPFPPPMMPPPGPPPPMMPPP
PPPPPPPMPPPPMPPPPMMPFFPPWWWPPPFFPPMMMPPPMPPPMMPPPP
PPPPPPPMPPPPMPPPMMPPFFPPWWWPPPFFPPMMPPPPMPPPMMMPPP
PPPPPPPMPPPPMPPPMMPPFFPPWWWPPPFFPPPMMPPPMPPPMMPPPP
PPPPPPPPMMPPMPPPMPPPFFPPPWWWPPPPFPPPMMPPMPPPMMMPPP
PPPPPPPMMPPPMPPPMPPPFFFPPWWWPPPFFPMMPPPPMPPPMMMPPP
PPPPPPPPMMPPMPPPMMPPFFPPPPWWWPPFFPMMPPPPMPPPMMPPPP
PPPPPPPPMMPPMPPPMMPPPFPPPPWWWPFFPPPMMPPPMPPPMMPPPP
PPPPPPPPPMPPGPPMMPPPFFPPPWWWPPPFPPPMMPPPGPPMMPPPPP
PPPPPPPPPMPPPPPMMPPPFFPPPWWWPPFFPPPPMPPPPPPPMPPPPP
PPPPPPPPMMPPPPPPMMPPPFPPPWWWPPPFPPPMMPPPPPPPMMPPPP
PPPPPPPPPPPPPPPPPPPPPPPPWWWPPPPPPPPPPPPPPPPPPPPPPP
PPPPPPPPPPPPPPPPPPPPPPPPWWWPPPPPPPPPPPPPPPPPPPPPPP
PPPPPPPPPPPPPPPPPPPPPPPWWWPPPPPPPPPPPPPPPPPPPPPPPP
PPFFFFPPPPPPPPPPPPPPPPPWWWPPPPPPPPPPPPPPPPPPPPPPPP
PPFFFFFFPPPPPPPPPPPPPPPWWWPPPPPPPPPPPPPPPPPPFFFFPP
PGPPPPFFPPPPPPPPPPPPPPPWWWPPPPPPPPPPPPPPPPFFFFFFPP
PGPTPPPPPGPPPPPPPPPPPPPPPPPPPPPPPPPPPPPPPPFFPPPPGP
PGPPPPFFPPPPPPPPPPPPPPPPPPPPPPPPPPPPPPPPGPPPPPTPGP
PPFFFFFFPPPPPPPPPPPPPPPWWWPPPPPPPPPPPPPPPPFFPPPPGP
PPFFFFPPPPPPPPPPPPPPPPPWWWPPPPPPPPPPPPPPPPFFFFFFPP
PPPPPPPPPPPPPPPPPPPPPPPPWWWPPPPPPPPPPPPPPPPPFFFFPP
PPPPPPPPPPPPPPPPPPPPPPPPWWWPPPPPPPPPPPPPPPPPPPPPPP
PPPPPSSSSSSPGPSSSSSSPPPPWWWPPPPPSSSSSSPGPSSSSSSPPP
PPPPSSSSSSPPPPSSSSSPPPPWWWPPPPSSSSSSPPPPSSSSSPPPPP
PPPPSSSSSSPPPPSSSSSSPPPWWWPPPPSSSSSSPPPPSSSSSSPPPP
PPPPSSSSSSPPPSSSSSSPPPPWWWPPPPPSSSSSSPPPSSSSSSPPPP
PPPSSSPPPPPPPPPPPSSPPPWWWPPPPPSSSPPPPPPPPPPPSSPPPP
PPPSSSPPPPSSSSPPSSSPPPWWWPPPPPSSSPPPPSSSSPPSSSPPPP
PPPSSSSPPSSSSSSPPPSSPPWWWPPPPPSSSSPPSSSSSSPPPSSPPP
PPPPSSSPPSSSBSSPPSSSPPWWWPPPPPPSSSPPSSBSSSPPSSSPPP
PPPPSSSPPPSSSSPPSSSSPPWWWPPPPPSSSPPPSSSSPPSSSSPPPP
PPPPSSSPPPPSSPPPSSSPPPWWWPPPPPSSSPPPPSSPPPSSSPPPPP
PPPPSSSPPPPPPPPSSSSPPPWWWPPPPPSSSPPPPPPPPSSSSPPPPP
PPPPPSSSSPPPPPPSSSSPPPPWWWPPPPPSSSSPPPPPPSSSSPPPPP
PPPPPPSSSSPGPSSSSPPPPPPWWWPPPPPPSSSSPGPSSSSPPPPPPP
PPPPPPPPPPPPPPPPPPPPPPPWWWPPPPPPPPPPPPPPPPPPPPPPPP
PPPPPPPPPPPPPPPPPPPPPPPWWWPPPPPPPPPPPPPPPPPPPPPPPP
PPPPPPPPPPPPPPPPPPPPPPPPPPPPPPPPPPPPPPPPPPPPPPPPPP
PPPPPPPPPPPPPPPPPPPPPPPPPPPPPPPPPPPPPPPPPPPPPPPPPP
PPPPPPPPPPPPPPPPPPPPPPPWWWPPPPPPPPPPPPPPPPPPPPPPPP
PPPPPPPPPPPPPPPPPPPPPPPWWWPPPPPPPPPPPPPPPPPPPPPPPP
PPPPPPPPPPPPPPPPPPPPPPPWWWPPPPPPPPPPPPPPPPPPPPPPPP